"","total_vaccinated","people_vaccinated","people_fully_vaccinated","maTotal","maPeople_vaccinated","maPeople_fully_vaccinated","date"
"1",0,0,0,NA,NA,NA,2021-04-15
"2",0,0,0,NA,NA,NA,2021-04-16
"3",0,0,0,NA,NA,NA,2021-04-17
"4",0,0,0,2189.42857142857,419,1770.42857142857,2021-04-18
"5",1177,537,640,2995.57142857143,591.142857142857,2404.42857142857,2021-04-19
"6",0,0,0,4643.71428571429,1369.57142857143,3274.14285714286,2021-04-20
"7",14149,2396,11753,6239.42857142857,2391.71428571429,3847.71428571429,2021-04-21
"8",5643,1205,4438,6832.71428571429,2827.85714285714,4004.85714285714,2021-04-22
"9",11537,5449,6088,6765.85714285714,2852.42857142857,3913.42857142857,2021-04-23
"10",11170,7155,4015,9227.42857142857,4976.14285714286,4251.28571428571,2021-04-24
"11",4153,3053,1100,8510.42857142857,5810.71428571429,2699.71428571429,2021-04-25
"12",709,709,0,11451.5714285714,8819.57142857143,2632,2021-04-26
"13",17231,14866,2365,13229.8571428571,11042.7142857143,2187.14285714286,2021-04-27
"14",9130,8238,892,14810.4285714286,12877.4285714286,1933,2021-04-28
"15",26231,22267,3964,15811.7142857143,13690.1428571429,2121.57142857143,2021-04-29
"16",23985,21011,2974,15710.4285714286,13588.8571428571,2121.57142857143,2021-04-30
"17",22234,19998,2236,16624.4285714286,14588.7142857143,2035.71428571429,2021-05-01
"18",11162,8742,2420,19295.7142857143,17240.8571428571,2054.85714285714,2021-05-02
"19",0,0,0,21696.5714285714,19783,1913.57142857143,2021-05-03
"20",23629,21865,1764,23388.8571428571,21557.4285714286,1831.42857142857,2021-05-04
"21",27829,26803,1026,23980.7142857143,22289,1691.71428571429,2021-05-05
"22",43037,40062,2975,23161.1428571429,21797,1364.14285714286,2021-05-06
"23",35831,33432,2399,27730.4285714286,26286.5714285714,1443.85714285714,2021-05-07
"24",26377,25119,1258,26389.4285714286,25031.1428571429,1358.28571428571,2021-05-08
"25",5425,5298,127,22413.8571428571,21202.1428571429,1211.71428571429,2021-05-09
"26",31985,31427,558,20828,19746.8571428571,1081.14285714286,2021-05-10
"27",14242,13077,1165,19825.7142857143,18803.8571428571,1021.85714285714,2021-05-11
"28",0,0,0,18812,17858,954,2021-05-12
"29",31936,29875,2061,18037,17101.1428571429,935.857142857143,2021-05-13
"30",28815,26831,1984,19300.5714285714,18281.7142857143,1018.85714285714,2021-05-14
"31",19281,18498,783,18857,17693.5714285714,1163.42857142857,2021-05-15
"32",0,0,0,20898.7142857143,19333.5714285714,1565.14285714286,2021-05-16
"33",40830,39691,1139,19229.7142857143,17154.4285714286,2075.28571428571,2021-05-17
"34",11137,8960,2177,18114.2857142857,15649.8571428571,2464.42857142857,2021-05-18
"35",14292,11480,2812,20881.5714285714,15598.2857142857,5283.28571428571,2021-05-19
"36",20253,14621,5632,20881.5714285714,15598.2857142857,5283.28571428571,2021-05-20
"37",21007,16299,4708,15815.2857142857,10379.4285714286,5435.85714285714,2021-05-21
"38",38652,18137,20515,16581.2857142857,10347.7142857143,6233.57142857143,2021-05-22
"39",0,0,0,14539.5714285714,8707.71428571429,5831.85714285714,2021-05-23
"40",5366,3159,2207,20690.1428571429,10235,10455.1428571429,2021-05-24
"41",16499,8738,7761,20695.2857142857,8967.85714285714,11727.4285714286,2021-05-25
"42",0,0,0,18232,7618.42857142857,10613.5714285714,2021-05-26
"43",63307,25312,37995,20450.2857142857,7898,12552.2857142857,2021-05-27
"44",21043,7429,13614,18772.8571428571,4649.85714285714,14123,2021-05-28
"45",21409,8691,12718,21667.5714285714,6850.71428571429,14816.8571428571,2021-05-29
"46",15528,1957,13571,23318.7142857143,7156.42857142857,16162.2857142857,2021-05-30
"47",-6376,-19578,13202,17059.2857142857,3968.42857142857,13090.8571428571,2021-05-31
"48",36762,24144,12618,17521.7142857143,3857.71428571429,13664,2021-06-01
"49",11558,2140,9418,17958.7142857143,3390.14285714286,14568.5714285714,2021-06-02
"50",19491,2996,16495,17369.8571428571,3628.42857142857,13741.4285714286,2021-06-03
"51",24280,6654,17626,19214.5714285714,6916.71428571429,12297.8571428571,2021-06-04
"52",24468,5418,19050,16452,4122.85714285714,12329.1428571429,2021-06-05
"53",11406,3625,7781,17224.8571428571,4244.71428571429,12980.1428571429,2021-06-06
"54",6537,3440,3097,17264.4285714286,4406.57142857143,12857.8571428571,2021-06-07
"55",17424,4587,12837,17445.4285714286,4905.85714285714,12539.5714285714,2021-06-08
"56",16968,2993,13975,16637.2857142857,4723.42857142857,11913.8571428571,2021-06-09
"57",19768,4129,15639,16389.8571428571,4336.42857142857,12053.4285714286,2021-06-10
"58",25547,10149,15398,15808.5714285714,3860.57142857143,11948,2021-06-11
"59",18811,4141,14670,14929.7142857143,3752.42857142857,11177.2857142857,2021-06-12
"60",9674,916,8758,12505.7142857143,3324.85714285714,9180.85714285714,2021-06-13
"61",2468,109,2359,11427.2857142857,3008.42857142857,8418.85714285714,2021-06-14
"62",11272,3830,7442,14747.7142857143,4850.71428571429,9897,2021-06-15
"63",0,0,0,15737.7142857143,5851,9886.71428571429,2021-06-16
"64",12219,1914,10305,14355.7142857143,5720.14285714286,8635.57142857143,2021-06-17
"65",48790,23045,25745,18761.1428571429,9533.42857142857,9227.71428571429,2021-06-18
"66",25741,11143,14598,20928.4285714286,11515.5714285714,9412.85714285714,2021-06-19
"67",0,0,0,20928.4285714286,11515.5714285714,9412.85714285714,2021-06-20
"68",33306,26802,6504,30558.8571428571,19174.2857142857,11384.5714285714,2021-06-21
"69",26443,17705,8738,28410.2857142857,18057,10353.2857142857,2021-06-22
"70",0,0,0,28521.8571428571,18668.2857142857,9853.57142857143,2021-06-23
"71",79632,55525,24107,28521.8571428571,18668.2857142857,9853.57142857143,2021-06-24
"72",33750,15224,18526,24869,15098,9771,2021-06-25
"73",26522,15422,11100,27381,16834.4285714286,10546.5714285714,2021-06-26
"74",0,0,0,29830.8571428571,17491.5714285714,12339.2857142857,2021-06-27
"75",7736,1810,5926,18454.8571428571,9559.42857142857,8895.42857142857,2021-06-28
"76",44027,29860,14167,18277.8571428571,9077.71428571429,9200.14285714286,2021-06-29
"77",17149,4600,12549,14489,6874.57142857143,7614.42857142857,2021-06-30
"78",0,0,0,17448,8343.85714285714,9104.14285714286,2021-07-01
"79",32511,11852,20659,17320.5714285714,8780.57142857143,8540,2021-07-02
"80",0,0,0,13126.8571428571,5776.71428571429,7350.14285714286,2021-07-03
"81",20713,10285,10428,10677,5119.57142857143,5557.42857142857,2021-07-04
"82",6844,4867,1977,18439.5714285714,9962.14285714286,8477.42857142857,2021-07-05
"83",14671,8833,5838,17507.7142857143,10505.5714285714,7002.14285714286,2021-07-06
"84",0,0,0,17507.7142857143,10505.5714285714,7002.14285714286,2021-07-07
"85",54338,33898,20440,18243,11319.5714285714,6923.42857142857,2021-07-08
"86",25988,15656,10332,18468.8571428571,11078,7390.85714285714,2021-07-09
"87",0,0,0,18021.5714285714,10560.8571428571,7460.71428571429,2021-07-10
"88",25860,15983,9877,18021.5714285714,10560.8571428571,7460.71428571429,2021-07-11
"89",8425,3176,5249,14637.2857142857,6831.57142857143,7805.71428571429,2021-07-12
"90",11540,5213,6327,16260.4285714286,6002.42857142857,10258,2021-07-13
"91",0,0,0,16260.4285714286,6002.42857142857,10258,2021-07-14
"92",30648,7793,22855,16967.4285714286,4106.57142857143,12860.8571428571,2021-07-15
"93",37350,9852,27498,16404.1428571429,3752.14285714286,12652,2021-07-16
"94",0,0,0,17469.7142857143,3744.42857142857,13725.2857142857,2021-07-17
"95",30809,2712,28097,21657.4285714286,4214.14285714286,17443.2857142857,2021-07-18
"96",4482,695,3787,21841.5714285714,3347.85714285714,18493.7142857143,2021-07-19
"97",18999,5159,13840,16505.8571428571,1940.42857142857,14565.4285714286,2021-07-20
"98",29314,3288,26026,20641,1995.14285714286,18645.8571428571,2021-07-21
"99",31937,1729,30208,16239.7142857143,1607.71428571429,14632,2021-07-22
"100",0,0,0,16202.2857142857,1550.28571428571,14652,2021-07-23
"101",28946,383,28563,16046.5714285714,2026.28571428571,14020.2857142857,2021-07-24
"102",0,0,0,14762.8571428571,3290.42857142857,11472.4285714286,2021-07-25
"103",4220,293,3927,15033.5714285714,6836,8197.57142857143,2021-07-26
"104",17909,8491,9418,18832.7142857143,9748.85714285714,9083.85714285714,2021-07-27
"105",20328,12137,8191,20231.7142857143,14446.1428571429,5785.57142857143,2021-07-28
"106",33832,26548,7284,22841.8571428571,16799.4285714286,6042.42857142857,2021-07-29
"107",26594,20390,6204,41737.4285714286,18259.5714285714,23477.8571428571,2021-07-30
"108",38739,33264,5475,39179,17046.5714285714,22132.4285714286,2021-07-31
"109",18271,16473,1798,54579.5714285714,23467.4285714286,31112.1428571429,2021-08-01
"110",136489,10514,125975,58437.8571428571,23562.1428571429,34875.7142857143,2021-08-02
"111",0,0,0,69332.1428571429,26570.4285714286,42761.7142857143,2021-08-03
"112",128132,57083,71049,77405,28327,49078,2021-08-04
"113",60840,27211,33629,74794.8571428571,25973.7142857143,48821.1428571429,2021-08-05
"114",102854,41448,61406,61896.8571428571,28128.7142857143,33768.1428571429,2021-08-06
"115",95249,45560,49689,61896.8571428571,28128.7142857143,33768.1428571429,2021-08-07
"116",0,0,0,43592.2857142857,19974,23618.2857142857,2021-08-08
"117",46203,25599,20604,70778.4285714286,35778.2857142857,35000.1428571429,2021-08-09
"118",0,0,0,77190.2857142857,41269.2857142857,35921,2021-08-10
"119",0,0,0,77742.4285714286,43072.8571428571,34669.5714285714,2021-08-11
"120",251143,137841,113302,86537.4285714286,48379.2857142857,38158.1428571429,2021-08-12
"121",147737,79885,67852,83718.4285714286,47151.4285714286,36567,2021-08-13
"122",99114,58185,40929,92415.1428571429,52804,39611.1428571429,2021-08-14
"123",61565,37145,24420,92415.1428571429,52804,39611.1428571429,2021-08-15
"124",26470,17004,9466,87226.4285714286,54290.2857142857,32936.1428571429,2021-08-16
"125",60877,39568,21309,85755.8571428571,56382.5714285714,29373.2857142857,2021-08-17
"126",0,0,0,84091,56774.8571428571,27316.1428571429,2021-08-18
"127",214822,148245,66577,84862.4285714286,58542.5714285714,26319.8571428571,2021-08-19
"128",137443,94531,42912,84653,59124.4285714286,25528.5714285714,2021-08-20
"129",87460,60931,26529,86755.4285714286,61673.5714285714,25081.8571428571,2021-08-21
"130",66965,49519,17446,95731.2857142857,68381.8571428571,27349.4285714286,2021-08-22
"131",25004,21077,3927,65042.4285714286,47204,17838.4285714286,2021-08-23
"132",75594,57412,18182,54524.1428571429,39896.8571428571,14627.2857142857,2021-08-24
"133",62831,46958,15873,61172.1428571429,45168,16004.1428571429,2021-08-25
"134",0,0,0,58308.5714285714,42445.5714285714,15863,2021-08-26
"135",63815,43381,20434,57994.1428571429,41331.2857142857,16662.8571428571,2021-08-27
"136",133996,97829,36167,51981.5714285714,36488.4285714286,15493.1428571429,2021-08-28
"137",46920,30462,16458,48754.4285714286,34197.5714285714,14556.8571428571,2021-08-29
"138",22803,13277,9526,54551.8571428571,38395.2857142857,16156.5714285714,2021-08-30
"139",33506,23512,9994,50406.4285714286,35876.8571428571,14529.5714285714,2021-08-31
"140",40241,30922,9319,33385.5714285714,23056.8571428571,10328.7142857143,2021-09-01
"141",40582,29384,11198,26682.7142857143,18705.1428571429,7977.57142857143,2021-09-02
"142",34797,25752,9045,25417.4285714286,17903.4285714286,7514,2021-09-03
"143",14850,8089,6761,23461,16646.7142857143,6814.28571428571,2021-09-04
"144",0,0,0,17712.2857142857,12229.2857142857,5483,2021-09-05
"145",13946,7665,6281,18462.8571428571,13959.8571428571,4503,2021-09-06
"146",19811,14715,5096,19910.2857142857,14814.4285714286,5095.85714285714,2021-09-07
"147",0,0,0,20335.7142857143,16136.5714285714,4199.14285714286,2021-09-08
"148",45836,41498,4338,21342.4285714286,16979.7142857143,4362.71428571429,2021-09-09
"149",44929,31734,13195,20863.4285714286,16879.8571428571,3983.57142857143,2021-09-10
"150",17828,17344,484,20084.5714285714,16566.4285714286,3518.14285714286,2021-09-11
"151",7047,5902,1145,20084.5714285714,16566.4285714286,3518.14285714286,2021-09-12
"152",10593,6966,3627,25960.7142857143,19677.7142857143,6283,2021-09-13
"153",14359,12521,1838,18529,12671.4285714286,5857.57142857143,2021-09-14
"154",0,0,0,26446.2857142857,19697.4285714286,6748.85714285714,2021-09-15
"155",86969,63277,23692,27214.1428571429,20385.5714285714,6828.57142857143,2021-09-16
"156",-7093,-17310,10217,25700.8571428571,19390.4285714286,6310.42857142857,2021-09-17
"157",73249,66526,6723,27478.8571428571,20292.8571428571,7186,2021-09-18
"158",12422,10719,1703,33336.8571428571,24127.5714285714,9209.28571428571,2021-09-19
"159",0,0,0,28090,18632.8571428571,9457.14285714286,2021-09-20
"160",26805,18838,7967,29103.2857142857,21105.7142857143,7997.57142857143,2021-09-21
"161",41006,26843,14163,30898.2857142857,17499.4285714286,13398.8571428571,2021-09-22
"162",50241,24814,25427,30735.1428571429,16538.2857142857,14196.8571428571,2021-09-23
"163",0,0,0,33236.1428571429,18530.1428571429,14706,2021-09-24
"164",85814,41282,44532,29406.8571428571,15839,13567.8571428571,2021-09-25
"165",11280,3991,7289,29276.1428571429,14438.2857142857,14837.8571428571,2021-09-26
"166",17507,13943,3564,24682.5714285714,10893.4285714286,13789.1428571429,2021-09-27
"167",0,0,0,33881.4285714286,16245.5714285714,17635.8571428571,2021-09-28
"168",40091,17038,23053,21622.2857142857,10348.1428571429,11274.1428571429,2021-09-29
"169",18086,0,18086,26803.5714285714,12366.5714285714,14437,2021-09-30
"170",64392,37465,26927,26123.1428571429,11302.1428571429,14821,2021-10-01
"171",0,0,0,29004.1428571429,12716.1428571429,16288,2021-10-02
"172",47549,18120,29429,23276.8571428571,10282.1428571429,12994.7142857143,2021-10-03
"173",12744,6492,6252,28522,12669.1428571429,15852.8571428571,2021-10-04
"174",20167,9898,10269,24678,9028.14285714286,15649.8571428571,2021-10-05
"175",0,0,0,24678,9028.14285714286,15649.8571428571,2021-10-06
"176",54802,16709,38093,17885.2857142857,6439.57142857143,11445.7142857143,2021-10-07
"177",37484,11978,25506,23637,7353.57142857143,16283.4285714286,2021-10-08
"178",0,0,0,26055.2857142857,7430.28571428571,18625,2021-10-09
"179",0,0,0,32893.1428571429,8753.28571428571,24139.8571428571,2021-10-10
"180",53006,12890,40116,33575.1428571429,8025.57142857143,25549.5714285714,2021-10-11
"181",37095,10435,26660,28220.2857142857,6314.42857142857,21905.8571428571,2021-10-12
"182",47865,9261,38604,46692.7142857143,9384.57142857143,37308.1428571429,2021-10-13
"183",59576,11615,47961,52870.7142857143,10437.4285714286,42433.2857142857,2021-10-14
"184",0,0,0,45298.4285714286,8596,36702.4285714286,2021-10-15
"185",129307,21491,107816,55114.4285714286,9492,45622.4285714286,2021-10-16
"186",43246,7370,35876,48276.5714285714,8169,40107.5714285714,2021-10-17
"187",0,0,0,39765.7142857143,6509.71428571429,33256,2021-10-18
"188",105807,16707,89100,63219.7142857143,12421.4285714286,50798.2857142857,2021-10-19
"189",0,0,0,44747.2857142857,9351.28571428571,35396,2021-10-20
"190",0,0,0,45885.2857142857,10790,35095.2857142857,2021-10-21
"191",164178,41382,122796,46369.2857142857,10913,35456.2857142857,2021-10-22
"192",0,0,0,34377,9568.85714285714,24808.1428571429,2021-10-23
"193",51212,17441,33771,45117.8571428571,16461.2857142857,28656.5714285714,2021-10-24
"194",3388,861,2527,50109,18771.1428571429,31337.8571428571,2021-10-25
"195",21861,7298,14563,32145,15416.1428571429,16728.8571428571,2021-10-26
"196",75186,48247,26939,37245.2857142857,17571.1428571429,19674.1428571429,2021-10-27
"197",34938,16169,18769,31339.7142857143,15790,15549.7142857143,2021-10-28
"198",38430,17897,20533,32024.8571428571,16500.2857142857,15524.5714285714,2021-10-29
"199",35702,15085,20617,30888.4285714286,16839.7142857143,14048.7142857143,2021-10-30
"200",9873,4973,4900,25308.7142857143,12704.4285714286,12604.2857142857,2021-10-31
"201",8184,5833,2351,22659.7142857143,11982.4285714286,10677.2857142857,2021-11-01
"202",13906,9674,4232,17169.7142857143,9425.71428571429,7744,2021-11-02
"203",36128,19300,16828,12069.4285714286,7270.71428571429,4798.71428571429,2021-11-03
"204",16395,11115,5280,19338.5714285714,12410.7142857143,6927.85714285714,2021-11-04
"205",0,0,0,20115.1428571429,12775,7340.14285714286,2021-11-05
"206",0,0,0,18128.5714285714,11393,6735.57142857143,2021-11-06
"207",60757,40953,19804,12967.4285714286,8635.85714285714,4331.57142857143,2021-11-07
"208",13620,8383,5237,10625.2857142857,7048,3577.28571428571,2021-11-08
"209",0,0,0,34647.2857142857,21775.7142857143,12871.5714285714,2021-11-09
"210",0,0,0,34647.2857142857,21775.7142857143,12871.5714285714,2021-11-10
"211",0,0,0,25967.7142857143,15925.2857142857,10042.4285714286,2021-11-11
"212",168154,103094,65060,37291.7142857143,22322.4285714286,14969.2857142857,2021-11-12
"213",0,0,0,42719.7142857143,25798.4285714286,16921.2857142857,2021-11-13
"214",0,0,0,47433.7142857143,28820.7142857143,18613,2021-11-14
"215",92888,53163,39725,47433.7142857143,28820.7142857143,18613,2021-11-15
"216",37996,24332,13664,33381.4285714286,20543.4285714286,12838,2021-11-16
"217",32998,21156,11842,33381.4285714286,20543.4285714286,12838,2021-11-17
"218",0,0,0,33381.4285714286,20543.4285714286,12838,2021-11-18
"219",69788,45153,24635,20111.7142857143,12948.7142857143,7163,2021-11-19
"220",0,0,0,29090.1428571429,18487.7142857143,10602.4285714286,2021-11-20
"221",0,0,0,30727.8571428571,20236.4285714286,10491.4285714286,2021-11-21
"222",0,0,0,38565.8571428571,25476,13089.8571428571,2021-11-22
"223",100845,63105,37740,34575,22913.8571428571,11661.1428571429,2021-11-23
"224",44462,33397,11065,34575,22913.8571428571,11661.1428571429,2021-11-24
"225",54866,36677,18189,46584.4285714286,31333.7142857143,15250.7142857143,2021-11-25
"226",41852,27218,14634,50954.4285714286,34685.5714285714,16268.8571428571,2021-11-26
"227",0,0,0,43408,30081.8571428571,13326.1428571429,2021-11-27
"228",84066,58939,25127,43166.8571428571,29678,13488.8571428571,2021-11-28
"229",30590,23463,7127,43681.4285714286,30115.4285714286,13566,2021-11-29
"230",48020,30879,17141,42435.7142857143,29729.4285714286,12706.2857142857,2021-11-30
"231",42774,30570,12204,42435.7142857143,29729.4285714286,12706.2857142857,2021-12-01
"232",58468,39739,18729,37040.7142857143,26431.8571428571,10608.8571428571,2021-12-02
"233",33132,24516,8616,33965.7142857143,24129,9836.71428571429,2021-12-03
"234",0,0,0,32444.7142857143,24008.8571428571,8435.85714285714,2021-12-04
"235",46301,35856,10445,34882.7142857143,26226.5714285714,8656.14285714286,2021-12-05
"236",9065,7343,1722,33547.7142857143,25936.2857142857,7611.42857142857,2021-12-06
"237",37373,30038,7335,28814.5714285714,22434,6380.57142857143,2021-12-07
"238",59840,46094,13746,37497.2857142857,28748.2857142857,8749,2021-12-08
"239",49123,37707,11416,33694.5714285714,25664.4285714286,8030.14285714286,2021-12-09
"240",0,0,0,35257.8571428571,26769.2857142857,8488.57142857143,2021-12-10
"241",60779,44200,16579,33887,25156.2857142857,8730.71428571429,2021-12-11
"242",19682,14269,5413,30405.1428571429,22129.7142857143,8275.42857142857,2021-12-12
"243",20008,15077,4931,23387.5714285714,16743,6644.57142857143,2021-12-13
"244",27777,18747,9030,23387.5714285714,16743,6644.57142857143,2021-12-14
"245",35467,24908,10559,32588,23298.1428571429,9289.85714285714,2021-12-15
"246",0,0,0,32526.8571428571,22738.2857142857,9788.57142857143,2021-12-16
"247",0,0,0,31682.4285714286,21733.2857142857,9949.14285714286,2021-12-17
"248",125182,90086,35096,32332.4285714286,21516,10816.4285714286,2021-12-18
"249",19254,10350,8904,27265.7142857143,17957.7142857143,9308,2021-12-19
"250",14097,8042,6055,27265.7142857143,17957.7142857143,9308,2021-12-20
"251",32327,17226,15101,27265.7142857143,17957.7142857143,9308,2021-12-21
"252",0,0,0,37389.4285714286,17209.5714285714,20179.8571428571,2021-12-22
"253",0,0,0,36124.1428571429,16253.7142857143,19870.4285714286,2021-12-23
"254",0,0,0,36259.1428571429,15742.2857142857,20516.8571428571,2021-12-24
"255",196048,84849,111199,31641,13281.4285714286,18359.5714285714,2021-12-25
"256",10397,3659,6738,31641,13281.4285714286,18359.5714285714,2021-12-26
"257",15042,4462,10580,31641,13281.4285714286,18359.5714285714,2021-12-27
"258",0,0,0,57213.7142857143,22869,34344.7142857143,2021-12-28
"259",0,0,0,29206.8571428571,10747.7142857143,18459.1428571429,2021-12-29
"260",0,0,0,27721.5714285714,10225,17496.5714285714,2021-12-30
"261",179009,67113,111896,30691.1428571429,11453.5714285714,19237.5714285714,2021-12-31
"262",0,0,0,31185.8571428571,11546.4285714286,19639.4285714286,2022-01-01
"263",0,0,0,33904.5714285714,12041.5714285714,21863,2022-01-02
"264",35829,13062,22767,33904.5714285714,12041.5714285714,21863,2022-01-03
"265",3463,650,2813,9544.42857142857,2564.28571428571,6980.14285714286,2022-01-04
"266",19031,3466,15565,9544.42857142857,2564.28571428571,6980.14285714286,2022-01-05
"267",0,0,0,9544.42857142857,2564.28571428571,6980.14285714286,2022-01-06
"268",8488,772,7716,4426,698.285714285714,3727.71428571429,2022-01-07
"269",0,0,0,15431.7142857143,4270.71428571429,11161,2022-01-08
"270",0,0,0,17218.1428571429,5061,12157.1428571429,2022-01-09
"271",0,0,0,21357.7142857143,6299,15058.7142857143,2022-01-10
"272",80503,25657,54846,24047.2857142857,6926.42857142857,17120.8571428571,2022-01-11
"273",31536,8998,22538,28748.8571428571,7848.14285714286,20900.7142857143,2022-01-12
"274",28977,8666,20311,28748.8571428571,7848.14285714286,20900.7142857143,2022-01-13
"275",27315,5164,22151,29356.4285714286,7997.85714285714,21358.5714285714,2022-01-14
"276",32911,6452,26459,21034.8571428571,4729,16305.8571428571,2022-01-15
"277",0,0,0,21119.8571428571,3918.14285714286,17201.7142857143,2022-01-16
"278",4253,1048,3205,21935.1428571429,3880.42857142857,18054.7142857143,2022-01-17
"279",22252,2775,19477,23473.2857142857,4604.42857142857,18868.8571428571,2022-01-18
"280",32131,3322,28809,18771.7142857143,3682.71428571429,15089,2022-01-19
"281",34684,8402,26282,18771.7142857143,3682.71428571429,15089,2022-01-20
"282",38082,10232,27850,25391.7142857143,5558.57142857143,19833.1428571429,2022-01-21
"283",0,0,0,24854.8571428571,5985.42857142857,18869.4285714286,2022-01-22
"284",0,0,0,24578,6428.57142857143,18149.4285714286,2022-01-23
"285",50593,14179,36414,25155.5714285714,6449,18706.5714285714,2022-01-24
"286",18494,5763,12731,24596.8571428571,6912.28571428571,17684.5714285714,2022-01-25
"287",30193,6424,23769,24596.8571428571,6912.28571428571,17684.5714285714,2022-01-26
"288",38727,8545,30182,24596.8571428571,6912.28571428571,17684.5714285714,2022-01-27
"289",34171,13475,20696,22896.8571428571,6275.14285714286,16621.7142857143,2022-01-28
"290",0,0,0,26573.5714285714,7338.85714285714,19234.7142857143,2022-01-29
"291",0,0,0,22260.2857142857,6421.14285714286,15839.1428571429,2022-01-30
"292",38693,9719,28974,16727.8571428571,5200.42857142857,11527.4285714286,2022-01-31
"293",44231,13209,31022,16223.8571428571,4700.71428571429,11523.1428571429,2022-02-01
"294",0,0,0,24601.4285714286,7256.42857142857,17345,2022-02-02
"295",0,0,0,26296,7998.71428571429,18297.2857142857,2022-02-03
"296",30643,9977,20666,22258.2857142857,7132.85714285714,15125.4285714286,2022-02-04
"297",58643,17890,40753,18037.2857142857,6075.71428571429,11961.5714285714,2022-02-05
"298",11862,5196,6666,21519.1428571429,7557.28571428571,13961.8571428571,2022-02-06
"299",10429,3658,6771,21519.1428571429,7557.28571428571,13961.8571428571,2022-02-07
"300",14684,5809,8875,23062,8062.57142857143,14999.4285714286,2022-02-08
"301",24373,10371,14002,16698.4285714286,6196.85714285714,10501.5714285714,2022-02-09
"302",0,0,0,15003.8571428571,5454.57142857143,9549.28571428571,2022-02-10
"303",41443,13514,27929,13945.8571428571,5084,8861.85714285714,2022-02-11
"304",14098,4830,9268,13545.4285714286,4944.57142857143,8600.85714285714,2022-02-12
"305",0,0,0,10063.5714285714,3463,6600.57142857143,2022-02-13
"306",3023,1064,1959,10063.5714285714,3463,6600.57142857143,2022-02-14
"307",11881,4833,7048,4143.14285714286,1532.42857142857,2610.71428571429,2022-02-15
"308",0,0,0,7222.71428571429,2699,4523.71428571429,2022-02-16
"309",0,0,0,7222.71428571429,2699,4523.71428571429,2022-02-17
"310",0,0,0,7702.28571428571,2934.71428571429,4767.57142857143,2022-02-18
"311",35655,12996,22659,6570.14285714286,2421.14285714286,4149,2022-02-19
"312",0,0,0,7664.28571428571,2724.85714285714,4939.42857142857,2022-02-20
"313",6380,2714,3666,8828,3056.42857142857,5771.57142857143,2022-02-21
"314",3956,1238,2718,11220.5714285714,4299.85714285714,6920.71428571429,2022-02-22
"315",7659,2126,5533,6127,2443.28571428571,3683.71428571429,2022-02-23
"316",8146,2321,5825,9834.14285714286,5183.57142857143,4650.57142857143,2022-02-24
"317",16748,8704,8044,14764,9930.42857142857,4833.57142857143,2022-02-25
"318",0,0,0,19345.1428571429,12893.8571428571,6451.28571428571,2022-02-26
"319",25950,19182,6768,24113.8571428571,17132.7142857143,6981.14285714286,2022-02-27
"320",40889,35942,4947,22950.1428571429,16801.1428571429,6149,2022-02-28
"321",36024,21982,14042,20557.5714285714,15557.7142857143,4999.85714285714,2022-03-01
"322",41040,31798,9242,20557.5714285714,15557.7142857143,4999.85714285714,2022-03-02
"323",0,0,0,38226.2857142857,30004,8222.28571428571,2022-03-03
"324",0,0,0,34253,26516,7737,2022-03-04
"325",0,0,0,29106.7142857143,23375.7142857143,5731,2022-03-05
"326",149631,120306,29325,23243.8571428571,18833.1428571429,4410.71428571429,2022-03-06
"327",13076,11526,1550,34138.4285714286,28257.7142857143,5880.71428571429,2022-03-07
"328",0,0,0,41148,34852.4285714286,6295.57142857143,2022-03-08
"329",0,0,0,41148,34852.4285714286,6295.57142857143,2022-03-09
"330",76262,65972,10290,19772.1428571429,17665.8571428571,2106.28571428571,2022-03-10
"331",49067,46163,2904,32075,28881,3194,2022-03-11
"332",0,0,0,38592,34606.2857142857,3985.71428571429,2022-03-12
"333",0,0,0,44538.4285714286,39591,4947.42857142857,2022-03-13
"334",99196,90032,9164,40124.5714285714,36105.5714285714,4019,2022-03-14
"335",45619,40077,5542,39828.1428571429,35145.1428571429,4683,2022-03-15
"336",41625,34893,6732,39828.1428571429,35145.1428571429,4683,2022-03-16
"337",45365,41574,3791,39828.1428571429,35145.1428571429,4683,2022-03-17
"338",46992,39440,7552,34894.7142857143,30350.8571428571,4543.85714285714,2022-03-18
"339",0,0,0,32225.8571428571,27400.1428571429,4825.71428571429,2022-03-19
"340",0,0,0,31611.7142857143,26344.4285714286,5267.28571428571,2022-03-20
"341",64662,56472,8190,25131,20405.2857142857,4725.71428571429,2022-03-21
"342",26937,19422,7515,23478.4285714286,17945.5714285714,5532.85714285714,2022-03-22
"343",37326,27503,9823,23478.4285714286,17945.5714285714,5532.85714285714,2022-03-23
"344",0,0,0,23478.4285714286,17945.5714285714,5532.85714285714,2022-03-24
"345",35424,22222,13202,17885.4285714286,12018.7142857143,5866.71428571429,2022-03-25
"346",0,0,0,15362.4285714286,9729.71428571429,5632.71428571429,2022-03-26
"347",0,0,0,13307.8571428571,7096.57142857143,6211.28571428571,2022-03-27
"348",25511,14984,10527,13307.8571428571,7096.57142857143,6211.28571428571,2022-03-28
"349",9276,3399,5877,15415.8571428571,6272.71428571429,9143.14285714286,2022-03-29
"350",22944,9071,13873,15415.8571428571,6272.71428571429,9143.14285714286,2022-03-30
"351",0,0,0,15415.8571428571,6272.71428571429,9143.14285714286,2022-03-31
"352",50180,16455,33725,11771.4285714286,4132.14285714286,7639.28571428571,2022-04-01
"353",0,0,0,20882.4285714286,7085.71428571429,13796.7142857143,2022-04-02
"354",0,0,0,21865.1428571429,6946.71428571429,14918.4285714286,2022-04-03
"355",0,0,0,28969,9107.42857142857,19861.5714285714,2022-04-04
"356",73053,24074,48979,21800.4285714286,6756.71428571429,15043.7142857143,2022-04-05
"357",29823,8098,21725,21800.4285714286,6756.71428571429,15043.7142857143,2022-04-06
"358",49727,15125,34602,21800.4285714286,6756.71428571429,15043.7142857143,2022-04-07
"359",0,0,0,39756.8571428571,13515.5714285714,26241.2857142857,2022-04-08
"360",0,0,0,29320.7142857143,10076.4285714286,19244.2857142857,2022-04-09
"361",0,0,0,32224.7142857143,11097.2857142857,21127.4285714286,2022-04-10
"362",125695,47312,78383,25120.8571428571,8936.57142857143,16184.2857142857,2022-04-11
"363",0,0,0,26481.8571428571,9134.57142857143,17347.2857142857,2022-04-12
"364",50151,15244,34907,26481.8571428571,9134.57142857143,17347.2857142857,2022-04-13
"365",0,0,0,26481.8571428571,9134.57142857143,17347.2857142857,2022-04-14
"366",9527,1386,8141,8723,2433.14285714286,6289.85714285714,2022-04-15
"367",0,0,0,8723,2433.14285714286,6289.85714285714,2022-04-16
"368",0,0,0,8017.57142857143,3237.42857142857,4780.14285714286,2022-04-17
"369",1383,402,981,8017.57142857143,3237.42857142857,4780.14285714286,2022-04-18
"370",0,0,0,6656.57142857143,3039.42857142857,3617.14285714286,2022-04-19
"371",45213,20874,24339,6656.57142857143,3039.42857142857,3617.14285714286,2022-04-20
"372",0,0,0,6656.57142857143,3039.42857142857,3617.14285714286,2022-04-21
"373",0,0,0,13031.1428571429,4025.42857142857,9005.71428571429,2022-04-22
"374",0,0,0,17641,4596.14285714286,13044.8571428571,2022-04-23
"375",0,0,0,11182,1614.14285714286,9567.85714285714,2022-04-24
"376",46005,7304,38701,11182,1614.14285714286,9567.85714285714,2022-04-25
"377",32269,3995,28274,11182,1614.14285714286,9567.85714285714,2022-04-26
"378",0,0,0,11182,1614.14285714286,9567.85714285714,2022-04-27
"379",0,0,0,11182,1614.14285714286,9567.85714285714,2022-04-28
"380",0,0,0,4609.85714285714,570.714285714286,4039.14285714286,2022-04-29
"381",0,0,0,14044.7142857143,2226.14285714286,11818.5714285714,2022-04-30
"382",0,0,0,15702.2857142857,2292.71428571429,13409.5714285714,2022-05-01
"383",0,0,0,NA,NA,NA,2022-05-02
"384",98313,15583,82730,NA,NA,NA,2022-05-03
"385",11603,466,11137,NA,NA,NA,2022-05-04
